



1111
1CE1
10P1
1001
1111














