111111111111111111111111111
1E00C00000000000000C00000C1
101001010010000010100000001
1010100010000000100C0000C01
1P00000C0000C00000000000001
111111111111111111111111111
